NO maps/images/yoshi.xpm
SO maps/images/yoshi.xpm
WE maps/images/yoshi.xpm
EA maps/images/yoshi.xpm

C 0,128,64

  1111
 11N01
110001
100111
1111
