NO maps/images/yoshi.xpm
SO maps/images/yoshi.xpm
WE maps/images/yoshi.xpm
EA maps/images/yoshi.xpm

F 255,255,128
C 0,128,64

  11E1
 11001
110001
100111
1111
