NO maps/images/yoshi.xpm
SO maps/images/yoshi.xpm
WE maps/images/yoshi.xpm
EA maps/images/yoshi.xpm

F 255,255,128
C 0,128,64

  111111111111111111111111111
 1100010000100001000010000101
11000000000000111001000111101
100000000000000000010000000011
100000011110000000010000000001
100000000010000000010000000001
1000E0000010000000000000000001
100000000000000000000000000001
100000000000000000000000000001
111111111111111111111111111111
