NO maps/images/yoshi.xpm
SO maps/images/yoshi.xpm
WE maps/images/yoshi.xpm
EA maps/images/yoshi.xpm

F 255,255,128
C 0,128,64

  111111111111111111111111111
 1100010000100001000010000101
110000E0000000100000000111101
10000000011111111111111100001
11111111111111111111111111111
