EA maps/images/GrasswallL_1.xpm
SO maps/images/BrownbrickD.xpm
WE maps/images/BrownbrickD.xpm
NO maps/images/BrownbrickL.xpm

F 74,74,74
C 178,49,43

        1111111111111111111111111
        1000000000110000000111001
        1011000001110001000001001
        1001000000000001111111001
111111111011000001110000000000001
100000000011000001110111111111111
111101111111110111000000100011
111101111111110111010100100011
110000001101010111000000100011
100000000000000000000000000011
100000000000000011010100100011
11000001110101011111011010N011
11110111 1110101 1011110100011
11111111 1111111 1111111111111
